%%%%%%%
%P.  G%
%     %
%     %
%   G %
%     %
%%%%%%%