%%%%%%%
%P..  %
%     %
%     %
%     %
%     %
%%%%%%%