%%%%%%%
%P....%
%....G%
%%%%%%%