%%%%%%%
%P.   %
%     %
%     %
%     %
%     %
%%%%%%%