%%%%%%%%
% % .% %
%G   P %
%%%%%%%%
