%%%%%%%
%  	 P%
%G   .%
%     %
%     %
%. G  %
%%%%%%%