%%%%%%%
% P	  %
%%%%% %
%  .  %
% %%%G%
%.    %
%%%%%%%